1.背景
	background-color - 背景色
		color -- 具体颜色
		transparent -- 透明
		inherit -- 从父元素继承
	background-image - 背景图像
		url('URL') -- 图像的URL
		none -- 无,默认
		inherit -- 从父元素继承
	background-repeat - 如何重复背景图像
		repeat -- 背景图像将向垂直和水平方向重复,默认
		repeat-x -- 只有水平位置会重复背景图像
		repeat-y -- 只有垂直位置会重复背景图像
		no-repeat -- background-image不会重复
		inherit	-- 从父元素继承
	background-postion - 背景图像的开始位置
	background-size - 背景图片的尺寸(cover,contain,percentage,length)
	background-attachment - 背景关联(fixed, scroll, inherit)

2.文本
	color - 文本颜色
	line-height - 设置行高
	text-indent - 首行缩进
	text-align - 对齐
	word-spacing - 单词与单词的间隔
	letter-spacing - 字母与字母的间隔
	text-transform - 字符转换(大小写)
	text-decoration - 文本装饰
	white-space - 处理空白符
	direction - 文本方向

3.字体
	font-family
	font-size
	font-weight -- 字体加粗
	font-style -- 字体风格

4.链接
	a:link - 普通的,未被访问的链接
	a:visited - 已访问的链接
	a:hover - 鼠标指针位于链接的上方
	a:active - 链接被点击的时刻

5.列表
	list-style-type
	list-style-image
	list-style-postion

6.表格
	border-collapse - 表格边框合并为单一的边框
	border-spacing - 分隔单元格边框的距离

7.轮廓 -- 位于边框边缘的外围，可起到突出元素的作用
	outline-color -- 轮廓的颜色
	outline-style -- 轮廓的样式
	outline-width -- 轮廓的宽度
	outline: #00FF00 dotted thick; -- 简写